Enhancer	Associated_Barcodes
AAAACGAAAGTAGTTCCTGATTACAAATTCCCGCAGTAAGCATTTCCATAAATAGGCAACCACATAG	CATAATACAACCCGACGTTGAAGGACGATA,GAAAACGAGAGGATTACAATAACAGTAGAA,TGATGAGCCTCTGTAAAGAACACTACGCCT,ACAACCAATCGCGGGGCCGCGTAGACTCAG,AATGAAAGAAAACAATTTCGAATAACAATA,GTTAAAAGCAAAAAAATCCGACCCCATCCA,AGAAATAAACTCTAAATTCGATGAAAGCAA,ACAAAAAGAACCCGCGCGACGATGATCCCT,AAATTTCACAATGTCACCAGCATACTACGG,CATGAATTAGAGATCGTTCCAAAAACGGGA,ACATGCAATTCAACCAATCTTGCAGAAAAA,TATAGCAACTATGACTCATAAGATGGCGCC,CCTGTTAAAACGACTATCATCAGAAATACA,AGGGGGACCAGGACCCCATAGACAGAGGAA,GAACATCGTACTTCCTACTGCAAAATTATA,TTTAAATTTCTAACTATTAAAAACAAAGCA,CGACCGTGCCAGGCGTAATGGTCACTGTTG
AAAAGGAATCTGATTTATCTGGCATCGCCTCCAGCTGTGTTCGTCTTCTCTTCCTAATCTCCTGGATGT	AGACCAATGAAAAATGAATAAAAAAACATG
AAAGTCATACGATGGATGACATGCTCCGCAACTGCGGAAATCCGTGGTCACACGGAAGTCAAGCGTC	CAGACGAATTTCATTTAATCATCGATATAA
AAATAGTGATGACGTGTCACCTGTCCCACACACAGCTGCTGAACGGAAAAATGGAAGACAAGATGCTG	TTTAGCAATAACCCAAATACACGGAGCCAA,AAAACTTGATGACGTCAAGTAACTAATTCA
AACCCGGATGTCTCGGCCTTATTCCTTTGAACTGCGGCCGGTGACCCTTTGGATCCTGAATCCGTTT	TTCAATACTAAGAACCCGATTAGAACTACT,CAAAGACTCTCTTCACTATACCGAGTTTAT,AACAAACGCACGAAAACCTCCTTTTAAAAT,AAGGGTAAAATTTGCAATAGATTTATCAAC,GATCCTGGCGTGGATAGGACATCAATGGCA,AGACGGAATTGACTAAAAACAGTTTTCAAC
AACCGCAGGAAGTCCGCTCTAAATGTTCTCACTGCGGTTAATTCCTCTAGACCTCTAACTTATCATA	TCACAGAAGAACAGTAGTGATTCCCATCAA,ATAGACAGAAAGACCAAGACAGTAAAGGTA,TAGAAAACGCCATAAGGTCGCCGAGGGCGG
AACTTACTTCCTTGCTTTGAGGATATTTCTCACAGCTGCAGCTTCCTTCAAGGTTTGTTTCGTTTTCT	TTGTGAACATACACACCTGGAACTGCGCGC,ATCTTGAATAACCAAGCGAAGAGGCGGTCG,CAAATAAATAACATAACCCAGACTCGGAGT,GGCACAGCAACAAGGCAGCCCAATTCCCAC,ATGCTTACACATAAGCTTGCTAGAAAGTAA,TTCAACTAACGAGTTAAACCTCAGAAAACA,GTTTAAATAACTTAACCCTGGGATAACAAA,CTAGAAACACAGCCGTCGCCAACCGAGGA
AACTTCCTGTGCAGCCTCGCTCTCTTGTTTCACAGCTGCTGTTGGCTGGGTATCCTTTGTTTCTTCAG	AAGCTAAACAGATACCTCCCATGCTTGCCT,TGAGTCCAGATGGTCCGACAACGACCCCGG,AAAACGACCGGGCCCGAAAACTTGATGTGC,CTCCACATCGAAAAATTTTGTAACTACGGT,ACCAGAAAAATAAAATTAATAATACAAAAA,CGGAATCCGGCAATCAACCATGTTCCTCTC,AACGAAAATACCTAACAGACGGAGGCAAGG,AATACATCTAATGGAGATAATAAAGCCGGA,GCCCAACGTACCACAAGAGTTATGGAAGGA
AAGGATCTTGTTAAAATCGTGTATTGTTTAACTGCGGTACAGGAATTCTGGGTTATTTATGTAATTT	CGCAAGGCTGATAGCTTCGAATGGAAGCA,TCAGCTGACAAAAAAATAGCGAACAATATC,GGAAACCAGTGAGACAACAGTAAAGAGGTA
AATGACCTTACTGAGAAGATCCAGAACCTCCACAGCTGAGTGCGACACTCCCCAATCCAAAACAGCAT	ATCAAGAAAAACTTTCTTAAACATCACCAA,TTTTCGTGGGCCAAGCCTCCCAGCCTTTAA,TTGGAAACACTCTAAAGCGAAAAGAATTTA,AAGTGATAAAAGAACCAGATAGCAAACATA,CATCCATATCATAACTAATTACAGCGGAAG,GTCACTAAAACAATCCGGAATAAGAAATAA,CTATACCGCAAGGTCCGGCACGAGAGGATA,ACTATGCATGGCTGCTAGGAGGATAGTCAG,GGGGCAGAATGTGAGATCACTTGTTGACAA
AATGTAGTTTGCTATTTCCATGCCACGTTACCGCAGTGGTGAATTCCTGCGATGCAAGATTAAAATC	GGGGAGAGGCCTGGTAAATTGTACACAGTC,CCCCCAACCAATGCGGCGCAACACGTCCTC,GATTAAAAAAATTGTGAACCCAAATCAAAA,CAGCAGAAATTCCGGCCAGCAATATGAGGT
AATTCTCAAAGACAAACGAAGGAATAACCACCAGCTGTGCAATTCCAGCATTCCCTGTCGTTACATAAC	TAATCTAACATCTCAGAAGTCAAGGCCCAT
ACAGTTGCATGGTTGGCATGATCCACCATACACAGCTGGGTTTCCAAAGTAGCCGGATGCACACAGTT	ATCCGGCCCACATTTCAGCACGGGATCAGC,GGTGTGAAACTAACACCCGAACTACAATA,AATTATGTATGATAAAGAGCGACCCACATA,GATATGCACATAAGCAAACCTCGCAGGGTA,CACGCGAGGAATTAGGCTTCTAGATGCTAC,CAGCAAAAACGAGAACGCGCACCAACTGAT,AATAACGCAACTAAACTCAGGACATGTGTA,AGTGAGAGAATGAGATGTCAGGGTGACCAG
ACGAACCTTTATAAACACTATTCAAACAAAACTGCGGAACCGGAACGGTGGATTTACCAAATGATTC	CAATGGAAGAGAAACACAGCTACCATACCA,TAAAAATAGTAATAAATAGTCAGTACACCG,CCAGCCTTCCTCACTATAGTATGAAAACAA,ATAAGATCCCTAGGCTAGAGATAAAGGTAA,AAGAATCAAACTGACAAACAAAAACGCAGA,GGCTAGGGGAAGTTCATTACTAGGCAACCG
ACGACAAGGTTCCTCAAAAACGGAATTTTAACTGCGGCGGAATAAAAAATAATAATAATAACTTTTT	AACAGTCTAGACAATAATATTCGATAACAA
ACGGCATGTGGACTGAATCTAGGATTTAAACACAGCTGACAGGATATTCAACATAATCCATAACATTT	GCGCGATGTATTATACGAGGAACACCAGAC,TGTCTGCGAACACATGTGCATCAAAAAGA
ACTTCCAAGGAAGCAATTTAGGAAATGTGACACAGCGGAAGAAACGCTGCATTGGTCAACGTTCTGTA	CAAGTGATAAAAATTTTTTCACTTAAAAAG
ACTTTTAATTCCATTTTTTCAGATGTAACTACTGCGGCTTCAAGGATGAATGGGGTGGTTTTGGAAG	AATAAGGGCGAGATTTTCTGAATTCCGAAA,GGACGTGCGTGCAAAAAGCATTGAGGAGAG,CGATCTTCCAGAAAATGCGTCAAAGATTTT,CCGTTAAATACACGACGGCAAGTCCAGATC,CAGGAGACCCTTTAAAGGGGAACGGAGACC,AATTACCGGAAGCTATGTTAAAAAATTTAA,GATTATGTGCGCACTCGCTGGAGGCACTTC,ATTCTAAGCAAGGATCTAGTAAATTAAAAA,TCAAAAAATAAGATATAACTCCAAAAGCAC,AAGAAGTACTAAGAAAACCGAAAAACATTG,ATGGCAAATTCAACTTGCGCATCACTCTAT,GAAGGTTTTACCTCCCAACTCCAGCTAGAA,GCTCGAACTAAAACTAACACAGATAAAGCT,TAGGAAACTAGGAATTGAGAAATATTAGAA,CAGAAAAAAGAAGGAGTTTCCAAAAAACGG,TATGCTCCGATAAGAGAGACATACAGGAAA
AGACCGGATATAATTAATTTGCTTTCCTTTCACAGCTGTCTAACCGTGCACGAATGTCTGTAGAATCG	ATAATCTCGGCTGAGAAACACAATCTCGGT,AAACTGAATGAAGGGAGGTCCGGAGCGAAA,TTGTATAACTTAAAACGAAAAATAAAAGAT
AGAGCAAGTCCGGGCATCCCACTTCCGCATCCAGCTGTGCTGAGATCCTCTCTGTGCTCTTCTTTAAAG	TCTGCCCACATACAATAGTAGCGTACCCGC,CAATTCCTGGACACCCGCTGACGAGGCTGC,AGACTAAAAACGTTATTCCAAAATAGCAAC,TTAAATAATTCACACGGCATAAATTATCAC,AAGAGGACTCTTCAAGTCCAAATATTCAAC,ATAACTAACGACACAATCAAGGCTGGGAAA,GAGATGAAGGCGATACCGTGGACAACCAAT,CATAGCCTATACGCAGGACTGATGCCGAGC,CATAATAAATATTAAAAGCAAAGAATAACA,GTGAATAAACCACATCACCGGAATGTCACG,ACATAAGAATAGCTGAGACTGAATATACGC,CTGTATCGGTCGAATCAAAAAATGTTCCAC
AGCTTCTGCGGGATTTCAGGCGTTGATCTCCCGCAGTGGGTTTATCCTTTCACCGCCGTTGTTCTGC	AAATAAAAACATTAGACGTTGAAATTAAA,CTTTGAGATACTTTAAACCTCGGGTAAATG
AGGAAAATCGGAATGCACAGACAGATAAAACACAGCTGTACCGGAAATGTCAGTATAAAAATAACAAA	TCCAGCAGAACAAAAAACGCAACAAAACGT,AGCAAGAAAAGAAACATCATTTACAACAGA,TGCCTGTGAAATACTCTGGGAGGATATGCT,TCATCAAAGAAAATAGTATCACAAAAAGAA
AGGAATGATTGACAGTCCATGAAACTGTATCCGCAGTTACGCAGCATTCTTAATGTTCTTGGTTTCC	GGCACATCCGAGCCCAACCTTCTCACGAAA
AGTGACTTATCCATGGTTGCCACTCCCATGCCCGCAGTCAGATTACTGGAGCTCTTGCAATGTGTGGAT	TTCAAGTAAACTAAGAACACAAATCTTCGC,CACACGCACTAATCTCAGTAGGTCGGACGA,CCGCCGGCAGGACATTCGGCATTACCAATG,GACGTAACACACAGCGATCACTCGAATATA,TAAAACGAAATTTACATGATGTCGGAGGAA
AGTGTAACTTCCTGTGTTTCATTTTCCTCCACTGCGGTATTCTCTTGTGTTTCCAAATTGTTTTGGT	AGAGAATAAATCAATAAATAAAATCAAAAT,AAAGGGAGGAATTGCCTGCACTGGCAGGAG,TCAGAGTGTACATCACACGCGAGGTCAAAA
ATAAGCAAGTACGAGGTGCGTGGAACAGAACAGCTGTGTTATAATGACTACCCCATCACACAAGGATA	CCAGAAGGTAAACCACCAAGGCCGACGAAC,TCAAAAAAAAAGGGAAATCTAAGGGGTAAA,ATAAGGACAGAAACTCCTATATCTGTCATA
ATACTGATCCGGATGAAATTTTGTGCTCCGGACTGCGGCAGGAGTTGGTACTCCTATATCAAAAGGTC	CCTAGAAGAATCGAGGAGAGACCCAGACCC,AACGAAGACTACAAAGAAATACCATGTTAA
ATATCCAACATGCTCCGCAACCGCGTGGCAACTGCGGAGATCCATGGTCACACGGAAGTCAAGCGTG	GGCACTAGGTCAATAGCTAACAGTAGAAAA,GTATACCGCCGCCCATCAACCTTGATCAGC,AGAGCTAGGATAAGCACACTAAAACAATGA,TGGATGAGATACACGCTACGAAAATATGAA,CCTTAACCTCGAATCGAAGCTATATAATAT,AGGAGAATAAGACGGAGAATCATTAAAGAT,TCTAACTTAATTATTACATAAGCATGAAAT,ATAGGCGGACCGCTTTGAGAGTAATCAAGC,TATACGAAAAATCACAAAAAAAACAGTTCA
ATCAAACCCGGAACCCATGAGGATATCAACGACTGCGGGACTTGGGAACTTGGTGACTGGGTAGCGAC	CTTAACACATTAAAAAAACAAGGCATTATC,ATAAATTAAAAAGAACCCAAGAATCATACG,GATATAAAAGAGAAATATTGAAATAGCACG,AAGAAGAATGTAAACGAGAAACTCAGGTGT,AATAAATTACAATAAAAAAACATATAAGAA,ATAGACTAATAAGTAACAGACCCATATCCA,AGTCGAGGTGTTATAAAGCCGTGAACACTC
ATCCACACACTGCAATAGCTTCAGCAACTCGACTGCGGGCATGGGAGTGGCAACCATGGATAAGTCAC	CCGATTAGTAGTTAAAAAAAACATAGAGCC,GAAATGACACGTAAATCCCTAAGTACTCCG,AAGAATAAGAGAAAACAGACTGTTGATTAC,GACAAAATTCGACCTGACCAGACATTCACG,TCATGAAGAGAAAACGCATAATAAAACTAA,ATTCTAAAATAAAATAATAGCTCATATGGA,CCAAAACAACATATCGAACGCATTACCAAT,CAGAAGAATCACTCGGAAAAAATGGCAAAC,AATCATCATAACATAGACTAAAGGAAATAC,ATTAAAAAAACATAATAAAAAAATTTACTA,TTTTAGCTCTCAAAAAACCCCAAATTATTA,CTAATGGTCTAAGTCAGCTGGAACTCACGT,TTAGTGACCGATGCATTCAGTACCAGAGGA,ACCTGAGCAAGGAGCCGCAACTTGGGCCCG
ATGTTATGTTCTAACGGTATCCATCTCACACCGCAGTTCTATACACCATTCAGAATATAGCTGGAAT	ATGCTCCAAGTGATAAAAACAACGGAGAAA,AAATATTTGCCGCCCATCCAGAACCCAGAT,TGACCAAACAATAGAAATGGATCGTGCGAA,CCTATAAGCGCAATCTTTGGACCTATAAGA,AAAGGATGGACTATGCCTAAGGTTATACA,AACGAAACCACTAGGCCCCTCTCCGTACAG,GGAAATAACCAGGAAGCCATATGATACGTT,AAAAGCTTAGGAAATCCAAAGTAGAAAGAG,TCACTAATGATAACAAAAACTTCGACCAAG
ATTATGTTCTGAAAGGTGTCCCATCTTCCCCCGCAGTACTATTACCTGATGCTAGATCCAAAATACT	ATCATTACTATCCAACAATAACGTACGAAT,CGGTAAGAAACAGTTTTAAAAGTCGCAGTA,CTAAGGTACAGGTTTATCCCACCCAGTCGG,CGAGCAGGCACCCAAACTGAACTGGAAGAA,ACCATCACCAACATAATAACACATTATCTA,AAAAAGTCACACTAATCGAAGATCATCATT,GACGCTTGCCCAATGGCACTGGCGAAGCAA,TCGAAAAAGATCCGTTGTCTGTACAAGGTT,CGAGAGCTAAGAGTTACGCTGAACGAATGT
ATTTATTCCTACATTTCCCAAGGATCAAAAACTGCGGTTCAAAATGTTTGATGCACATCACATTGTT	AAAAGAATAATAAATACCGGCTGGGAACAA,ATGACAATACACATAAACAGATGCCCAAAT,CCAACCATCTCAACAGTCGGATGATAACAA,CATAGCAGCGTCCGTGCATTCGAGGACACC,ACAATCACCGAAGCTGAGAGAGACATACAG,CTCCCGAAGGTCCCCTACTCGACATGTAGA,ACTAAATACCCACTCTGAAACTAAAACTAG
CAAGCGTGGAAATTTCCTTCAGTTTTCTTGCACAGCTGAATAGTTGTTCTTTACTTTTATATCATCCA	CCAGAGGGCCATGTTTCGGGACATCAAAGA
CAATGTTATGGAAAACAATTCCTGAACAAAACTGCGGAGATCGTGATGCACTCCACTTTTGCTCTGG	TGAAAAACCACCTGTGGGACTGTCCCCAGC,GTTTAGAAAAATCATCGAAATAATTACTGG,CCCTCTACCATGAAATAAATACAATAAACC,GCACGAAAACGTTCAGCATCATTATGATAT,TACCACGATCCGGTAGCAGATGAGGCGATA,GGCCCGTCCGAGAAATTTCCGAGGCCCCAG,ATGTTACATGATAGTACCGATCAAAATAAA
CACGCTTGACTTCCGTGTGACCATGGATCTCCGCAGTTGCCACGCGGTTGCGGAGCATGTTGGATAT	CAAATCTGAACTATTTCTGAAACAAAGCAC,GGCATATTATTCACCCCCGGACGACACCT,AAAGGAACCGTCCCTAGCTGACGATTCCAG,AGGTACTCACCTCTAGCTCACCGTCGCAG,TCCTAGAGGGTAGTTAGAAAGGTAAATATT,AAGAGCTGATGGCCAGCGTGCAAAAGTGGG,TCGTACAGCCTAAATGGCATCTAACAACGG,AACCTGAAAAAGAGCAGCACCTAACAAAAT,CCAATCCCAAGAATAAGTCAAAATAACCCA,GCGAAATAAACGAAGTCAAAGAGTTAAAAC,CGAGGAAAAAAGCCCCTTAGGTATCCAAAC,TATTACTTCAACAAAGCTCACTAACCGCAA
CACGGAACATCCGCCGGAACTCGACCCGGTACTGCGGGTTCAGGAACCCGTACAACAACGGGTTCAA	TGAAATACAGACGAACAATCGAGATACGAG,AGAACATTGATCAGGAAATGTGTATACCAT
CAGGCACACAAGTGAGACAAAGGTTCCACAACTGCGGATTGCAACCGGATGCTGAATCACGACCTTG	ATTAATTACGCCTCACTAGCATGCAACAAC,GCAGGAATCTACTTACGACGATCTCCCATA,AGAACAACTAAATCATGAAAGCATAATAAA,TGGACCCATGATATGCAAAGCCGGGGGGTA,TGACAAAAAGATATCAGCTCAAGCCCATAA,TTGTGCAAAAACAACACCGGACGAAATTAG,AAGAGCGATTAAGAGCAAACTACGAATTAA,TATAACCTCCTCTATCCGAATCTGACGAGT,AGTTACAGATATGATAAGTCGGAACCCGAG,TATCCAGGAAACCCAAGGGTGTATACCGAA
CAGTTGCAAAGTAAGACATAGGAATATAGTACTGCGGGGTAAAATGGGATACTGTTTGAACCCAATT	CAACGGGACCACAGCCGGCTAAAGCTTCGT,AGAAGCAACCAAATGATACAAGTGAATAAA,AAAAGCGAAAACTGGTCACACTTCATAACA,ATTTTACACATATATTAATAAAAGACAACA,GCCAAATCAACGAAAAGTAATTCGAAAAAA,CGAGGCCAGCAGCTACGCCCCGGTCCGGTT,AAAAAAGAAAGGAGACTAAGGAACCAACTC,ACTAATAGTGACTAAATACATATGCTAAGC,TCGAATAAAAAAAAAGAAAAAAAAAATTAC
CATTATTTGCTAACGGTATCCCATTTTACCCCGCAGTATTATATTCCATTATTCCCCAGCATTAATC	GAAGATGAAATTATTATAGGTACACATTCC,CACAAAACACTGAATGCCGAGAAAAGTTAA,AGGCAACTGGCTAATTGCTGCCGCACAAAA,TAAAAAATAACTAACAGAAGTAAATAACGA,CACAAATAAAACTTCCCACGCTTCGTGACG
CCAACTATCCGATCCGATATCCGGAAAGAGCCCGCTGTGATTGGCTGATTCGGGCACCGAATGTTAATG	CCACACGTGAAAGAACTCACCCATAGGAAA,TGCACAGAATGTCCAACAGACAAGGACGTG,GAATATATAAGATAGAGACACCTGAAAGAA,AAAAAAAAATAACTGGCAAAGAGGAAAATG,CACGTATTGGCAAGCTGCAAAGAAGAGCAA,CATACGCTAAGGACTAACTCAAGGCAAAAG,CGCAATCTAAAAACAAGAAAAAGACGGAAG,TAATGAACAGACAAACACAGATAACAAGAA,ACGCGGTTCAATAGAAGCACCAAGGCACCT,AAAAATCTCTGTTTATAAACTACGAAACAA,ACGCAATATCTAAGACCGATGTGAAACCTA,CAATTATAACTAAGGCATATAAAACCAAAA,TCAAAAACTATCTTCATCTCATCGAATAAT,ATGAGATCAAGGGAACGGAAACCGGATTGA,AAAGAGGTACATAAACGACATAGAATTCGG
CCCATGGGAGCCTGGATTAGTGGAAAGTCCCACAGCGGGGTTAGGCATATACATTCTTTGGAAAATTAT	GAACTAATGTCTTCCCACCCTTTGACACCC,CTAAATCGTAGCCGTAGCCTCAGCCAGGAC,AATCTATGTTCGATTGACGTTGGTCATCCG,ACGTTTCAAAAGAGATTTCCCAGGAATAGA,TAGTTAGCAGTTATCCACACCGGGCATATA,AAATTTACAGAAAGGGGTGGCCAGAAGAAA,GAAAACCTAGAATCCGTAGGAAAGCCAGGA,CTACATGGTAAAACATAATGGATCATGCCT,TTAGACGAACGGAAAAAAACAATAAATAAG,AAGTTCAGAATTCTGGGTTCGAGCGCAATT,GAGCATGAAAAACGAAAGATTGTATACGAT
CCCCGGTATATTCACCGACAAATACGTAACGACTGCGGATCAAATTTCCATTCCTTCGCACATTTTTG	AACAGTCCACGTATTCTGACGAAGATCCTA,AGAGGGGGCACTGCGTTACGGCCCCAAACA,GAATCGAATACCGATCATGCTCACTACATC,TATATGAAAAAGAATCCAGAGTATTAATAA,GATACTTATGATCCCTGGCACAGACAACGC,AGAAAAAACTCTTTTTCCTTAAGAACACCT,AGTACGTTTAGTAGTACCGGCAGACCAAAA,AAAGCGAATACGGGCAGATATCAGAACTGA,GAACGTAAAAAGAAGAAAAATACGCTGAAA,TAAAGTCCCCGCGGTCGGGACACGATCATA,ATATCTCCACTGTAAATAAAATGTACATCA,CAGAGCCCCGGTGCATCATTGATCCCAAAC,ACATTAGGGAAATTCCCTCCTAAACATACT,ACTGACGATTAACATGCAAGGTTCCAGTC,CCCTAATATATCTGAACCGAACTGCCGAAA,TACAATAAACTTAAGGTATAAATATCAAAT,GATAATCCGGAGCACCGAATAAACAATACC,GTAACAACTACATTATAAAACATTCAGAAC,AAATTAAGTTCAAACACTAGGAAATGTGAA,CAAAGTAGATGATTCCGAGAGACACCAAAT,AAGCAAAATTCAGATTACAGAATTTGGACA,AGCAAATGCAAGAAACCGACGCATCCATAT,CCTCGGTCACGCTGAAAAGAACCTCAACG,AAGAAGTCACCGGAAAACCCAGAGCGTTCG
CCGATGCCCGGAATATAAGCTCGCCGACTTCAGCTGTGGAAATTAACACAACATCGGGAATTGATATG	GATAATGAAAGTAACCAACACGAACCTGA,CAGTATATCAAAAAACAAGGGACTTATGGG,TTCAACTGCAAATTAAAAACGTTTATTATC,CAAAAGACACTATCGGCATAGATTACGACT,ATTAACAGAAAGGCAACCTGGAGTCATTCG,AATAACAGAAAACGTGCGTAACAAAAGAAG,TTGAATGTAAAGACTTACAGCCAATGTAAG
CGAAGTGGATCCAACCAGCCCAATAAATGACCGCAGTTGGTTCCTGGACCGTTGCATAAATCTCCCT	GATAACACCACACTGGGAAAAGCAGATCAA,ATTGAATGATACCGAACGAACAACATTACT,CGTATGCTGGGGAACAGAAGGGCGACATAC,TCCAACATAACAGCATGGCCAAACGGTAGA,TCGATGCGAAATAACATCAAGAGAATTTCA
CGCGCCAGGGAAAACTGCCGGGAAAATACAACTGCGGACCAGATTTTTGTTTTTTACATGCCTGTTC	AGTACGACAGACTCCCTTACTAACTCCACA,AATTCCGGGTCATCATAATAGAGCCCTACC,GACCGTAGTAAAAACCAGGATTACCCAAAG
CTAATTTGCATACGGAACTTATCCTTATATCCGCAGTGGCTTTAAGAAAATTTTCACGGTTGTGCTT	CATCCGTAATTAGCGATTTTGCAATCTGGT,AATCCCCACTCCGAACATCACGAAACATTA
CTCACTTACCAGTCCACTACATACAGAGAGCACAGCTGTGTGTTCCGGCCGTTCATTTACATATCCGG	TACAGATGGCAGAAACACACGATAAACATC,GAATACGTGGAAACACCGGGAAGAAGCAGG,GAAAAATAGCGCGATTCAATTTTGAAAATT,GATAAGATCTCGGAACGATGGAAAATACCC,ATAAGAGCCTACAGCGAGGGAATTTAAAAG,GATATAAAAATAATAAGAAATTACAAATCC,AAGATTTATCAACGTCAACAAAAACCCAAG,ACTTAAAACAGTAGGGTTCAATGGAACAAA,ACGGCACCGTTAGACCAAGACGAATTGGAC,TGCAGTGATAAATACACCCAATAAGGACTG,AAGAAAAAAATAACCATGATCTCGAACTAT,CGCTAAGGGGAGATCCCTTAACCTTAGGAT
CTGAAGATTTGAAATCCCATGGAAGTGAACCACAGCTGCCAACACTACAAGGATATGGAATATTTGGT	TAAGCCTGAGCTGGACACTCAAAAATACCC,AAAGCACCCAGAAACAGAAACTACCAAACG,TATCATTAAGGACATTCAATTAAGTTGAGA,CAAAAAGAAGATTGTAAGCGCCAGTATCCG,ATACAAAAACTAAACAGACATGGTACAGAA,GCCATAATATCTAAATCTTAAACACACCCT,ACAACGGTAAGAAGGAGCAAACGCGACAAC,ATAAGAAGACTTAGTGAACCAGAAAATAGA,TATACCAAGTCCCGTCAACAAAAAGATCAA,AAAAAACTAAGTGGATTTTAAGTATTAGAC,CAATTAACAAATCCCAAGAAATGTAAAAAC,CAACTCCAGGAAAGTTCGAGAGATGATAAT
CTGAGAGGAATTTACTAGGTTTCTAGAAGACAGCTGTGACTTAATTCCTCTGTGGTTTTGTATTTGCC	CTACCGGCTAAAAAATGAGACAGAAACTGT,CACAAAGGTGACAGGGATTCCGCCCTATAA
CTTCAAACTTGTCCGAATCATCCGTTGTGTCCGCTGTGTCAATCGCTTCCAACTCCCAAACCTGAACG	CAAAATAGAAATAAACCTTATAAAACAACA,AAACTCAACGCGACAGCCAGTGCGAATCCG,TTCACACTTTATACACGAAAACCACTCACC,ACCCACACATGACCCGCAGGCCGAACAATT,GAATTGGAGATGAGCAGAAGAAAATAACTG,GTTTCCCTAGATTATTCAGAATTGGCCATT,AGAATAAACTGATGAAATTTATTAGATCCG
CTTCGTCTGATCCAGCAACGAAAGCGATCTGACTGCGGTCCTATCCCATCCTATGTCGTGACATGTTG	CCCAATGTCTCCATCAGATTGGGCTGCTGA,AAAAAAAAAAAGTGACTCACAAACAAGTAT,TGAGAAATCCAAATAAAAGAACCCCATAAG,GAAATGCTAGATGCCTAGCGCCCATCCCGA,AAAAACAACAGACATCCCGAAGGATTACTC,AAAAAGTTGATGTACTCCCAAACAAAATTT,TTCGGAAGACAAATACAGCTCATTCCGTGC,TGGAAATAGTAAAAATCAATAACCAATAAA,ATCAGACGATAGCCCCCCGAACTGTAAGCA,AAATAACAAAAAAAGAAAAGAACACTAAAT,AAGCGGCATGAGATAACTACCGATAGATCC,GTCCCAGAACCTTTATTTCCCAGGAAACGG,CATACATAATAGACCTTATGAACAGGAGCT,AGATATACTTCAGAACAAGAGACTCAAGAG,GAGACTCGAAATAATAACCAGATATAAGAC,ATACCAAATGACTAACAATCGAGAACTCGA,TACACAGACAATATTGCATGCTGAGTACTG,AAAAGTAAATAAGTTAAGGAGAAATCCCAC,ATCAATACCACTTGAATATCAAAGAATTAG,AACAACAACCCACACGTCGACACCCCGCGC
CTTCTTTACACAGAAGATGGTTTAGACTTCACTGCGGAACGAACCGGTGGAATAACTGCACATATCC	AAAAAAAGAACAATAAATCATCTATCGGAG,GATCAGGGGGACAGCCCCGAACCCGAGGAA,TCTTACATCCTGACGTAGAAGCCCGCCGAC,CAACTTAGATATACCGAGACAGGATAATTT,CACAGAAAACATTGCCGCCGGGAAAACATT,CCAGACAGAAACAACCAGTAGGTCTTCAAT,AGTTATATCATCGCCAGGACAACAGGATAC,GATAAAATATCAACCGAAAAAAGACTAAGA,ACCTGTATAAGGGCACCCTTCCGGAACCAG,TAAAAATGAGACTCAATATAGGAACCTAAG,GACCACTGATACTATCCACCTGAGCCCAAA,CGCAGGAATACTCAAGAAGATCATAAACGT,TGGCTCAGAAGCTGAGAACCAATTGAGGAG,GAGCACCGGTACACATACCCCCACACGGAC,TGAAAGACAAGATTTTTGCATAGAGGGGTA,ATCAACGCCGGATAAATTACTAACTAATG,CGACAAAGATATAATTCCTCAAAGAAGACT,TGTCAACTATAAATCCAACTAATGAAAAAA
CTTTGATCCAGGCGAGGACTTTTGCTTCTCGACTGCGGGGAATTCCCAGAGTACTGTCGCTTGCTGTT	TAACATCGGAGGGACGGCTAACCGCAAAAC,GAATAAATCTTGATTGAACCTAATATCCAA,AAGAAAGTCAAATCCAAAAAAGAAGTAGCC,CCATTACTATATTTTGTCCAAAAGAACAAG,TGAACGTAGTAAACTGATTCGATAACATGT,TATGAATCGAACGCTTCTTTTGAAATTCCA,ATGTAAATTAAAACAATACAATAATGCAGT,CCGTAGCTCTGTAACCCGATACTCCTGAGA,GAAACCGCTAAGAAAAACGGGACGTGTGCG,AATCAATGGTTGAGACATTTGTGTTCCGT,AGAGATCAAATACAGTGAATTGCAGGAAAC,AAAAAAAAAAAATAGGTGGACATTTTTAAT,AACAAGTCAAATTCGCACTGCTCCGGATCA,AAAAAAAAAAATAGGTGGACATTTTTAAT,TGTCTCATTTGGGAAAGGAAACACTGATGA
CTTTTGCAGATATTAATACTGGATGAGCCAACTGCGGGCATGGATCCCTATTCACGACATAAACTAT	ATATTGAATACGTAGACGACATAGATGCTC,GCATGCTAATATTAATTGGAGATAAATACC,CCGAATAATGATTAAATAGAATATATTAAT,AAAAGGAACTTCCCCTAATAGAAGAGTCCA,TTAGCAAAAAATCGAAAAAATCTTAGTGAC,AAAATTAATGAAAAATTAATAAACTGATAG,CACCTTTGCAACACACGATCCTTAAACCTG,TAGCACACATACGTATCAGGATTTTCGATA,CCAACAAAAACGTTCCAACCCATAAAAAAG,CAGCAATTAAAAATTCCGGGTAACGCAATA,AAAGGATCTTCAAGGAATAGTAAGCGAACG,AAAGGATCAGACAAAGTGATATCGGACCAC,ACCAAAACATCCGACATAAGGGTCATTACC,ACGGGCGGAGGGAGACTAGCCCCACGATTT,CCTAATACCACAGAATAGAGCGTGGGATTT,ATTTGAATAGATTAGAACCGTTCAAACACA,CAATAGAGCCGGTCACAGTCAACACACAAG,AGTAAAAGATTTGTACGGGCAAAGGAGTCA,ATGCTGACCCATATGATGAGGCGAGGTAAA,GAGTCTAAAAGGAGTAAAATCTATATTACC,CAAAGGACACGACTTATAAAACAGCAAAGA,AAATCAAGAAACCAAGAAAAAACGAAGCAA,TTGGAAAAGTATACAAATGCATGAATTGCG
CTTTTGCAGATATTAATACTGGATGAGCCAACTGCGGGCATGGATCCTTATTCACGACATAAACTAT	TAACAAAAGGTCCATAAGCGCCCCTCCCG,TATATAAAGTGGTGCAAATGCATAGGCAC,GTACCAACCAGTAAAAGGATGAGACCTCAG,ACCAAAACTACGGCCCGCCCCGATGGACTT,AAGCGTAACCAGGATGACAATCACAGCGAT,TCTAGGTAGAAGGAAAGAGGACTAATACAC,GGCAGTAGTACTAGAAAAAACCCTCCCCAA,AAAAATAGCTTGAAGCTACAGCAATATTAA,AGAGGCTAGTCATACTTGCGAGTACATTA,ATAAAAACAAAATAAGAAATAAAACTACCT,TTCGCCCACTTAACGGAGAATAAAGTGGGC,GAACCAATAAAATCAAGTCGACAGATAACA,TGGAAGAGAAAATCTCCACGCTGAGCATCA,ACACGTGAAATGAGCCACTCAACACATGCA,CAAACGAGCAGAATCACAAATAGAACACAA,CAATCAAAATGTGCCTTCTATTTTAGACGG,ACCTGGAATTCGGCAGTACCTACAGCGGAA,GCGATGACAAATAAAGGAGCAATTCAACTA,TTACCTCGAAACATCACTCAAACTGGAGGA,TAACCCGACTGTTCGCCCTCAAACGTAACG,ATGGAAGAAGCAGATCCAAACAAAAAAAGA,GACAATTTAACTACTAAGACTAAAATCAAA,AGTCGTCATAAGTTAACCGTGTAATATCC,ACGCAGTCCACCCGATGAAAGACGAAAAAA,ACCCAAACAGAGAGAGTCGGGCGGACGTTC,TAAACAAATGGCTACGAAAAGTGCGCAATG,CGCCTAAGAGCTTATAGAATCTCAATACCA
GAACTATGTGGTAACGGCATCCATCTTACCCCGCAGTATTATATCCTATTGTATAAATTGTAAGGGA	TAAGAGCATTAAGCGAATAAAAATAATAAA
GAGAATCGGACTGAACAACATCCAGAAGGAACTGCGGTTGGACGAGCGGAAGTCTGACGTGTTCCAG	GGCTGTTTGACAGCAGAAGGTTCAAACACG
GAGTTACAGGCAGGTGCGCTAGCCAATTGGCCGCAGTGTCGCGGAAGTCTGGTTTCCATCAGCTACT	CTTTTCGAACCACGTGCCCCTTAGACGAGC
GCAATTAGTTTCCTTGTTTACGGAACAAACGACTGCGGGGGTGCGAATTGTGACGTCATCAATCAAAC	ACTGAACACGATATCCGCCATACATAACCT,TTAAGAGGCGGGTATAAATGGGAGAAAGAT,CATATCTTGGTATTGAGAATATAGTTCGGG,TTCTTCAACCGCTGGACGACGGTTAATTAC,TACCTATTAGTCCCCCGGGATTGAACAATC
GCATCCTCTTGTCCTTCCAAAGGTGAAACACCGCAGTCTGCTATCATATCCAATTTGTCTTCGATTG	TAAAAAGGTTGATCCAAAAAGACCAATACA,AAAAATAATAAATATCGAAAAAAAACAATA,GCAAGAAAAAAAGTATTTAAGAATTATAAG,CTGTTCGAGAATTGACCGCACGTTAGAAGG,GTAATATTTGCGCTGAGAGACACCAGTGCT,GCGGACACAAAGCTGAAAATAACAGCATAA,AACAAAAACCAGACATCATGAAGAAACAGA,ATAAAGGGAATCATACGAAGACAAGAGATC
GCATCCTTTTTTAACAAGCAGCTATCTTTACCGCAGTCGTAACAATCCCCACACTGCAAGTGTGAAT	CTCTGGATAACAACCACATCGAGTCCAGCA,TGCATCGGAGCCTCAACGTACCTAAAAGAG,AGTAACTCACTCTGCGTTCGCACTCACGGC,AATAAAAAAGCCTAATCACACGGGCAAAAC,ATAAAATAAGAAATCATCTTCATCGCCACG,AAATAATAACAAAGAGTAAGAGTAAAACAA,AAACCGGCAGAAGCTAACGGTAAAGGAGTC,TTGAATAGATAACGTTGAGTCCGAGTTTAC,GAAAATAAAATTAAAATACAGTACCAAAGT,AATGTCCACAGTTAATGGAATTTTTTCGCT,AATAAATCCATAAAATTAGATGAGCATAAT,ATCAACATAAGATAAGAAGCGAAAAATAGA,AAAGACAGAAGTTACAGAACAGGGGCGCAA,TAACTATAACAGAATCACACCCAAATAATA
GCCATGGATTGCATGATAGCTGTAAGGAATGACTGCGGATTGAACAAACCACCGAGCCAAACAACATT	GGCCATAGCTAAACTTGAAGCATTATCGC,CGAAACAATATGAACCCGATATAAAGTACT,TAAGCACTATAGTTCACCAGGGTGGGGTGT,AACATAGAAAAAACTACGAACGGAAAAGCT,GTCCAATGAATGAGCCTAGATAATAATTAC,AAGCATAGAACAGAGAAAAACAAAAAAAAG
GCCTACATCCTACGACCCAAGGAATGCCACACTGCGGGACCTCACCCACATAGAATAGAATGGGTAT	TGCATCGAAACTTCGAAAGAGGTGCCGAAA,TATTACCTAACTTTTCCGTCAACGTAATAG,AATGAACTAAAACTCATGGATAATATAGAT,ATCCAACAAATTTTAGCCTATACGTATGAG,TAAAAAACTTAAAAATCGACGATAACCAAA,GGATGAAACGCAAGACCAACGATGTAGTCG,TATCGCTGATAAAATGCAGATTTGCCTAGT,GAAACCAAAATGGTCTATGATAAACCTCCT,TGACACAATAAAGTACACCAATATAATGGA,GCCCTTTTGTACCGAACGATGGGGGATCAG,CAACTTGTTGGAATCCAACCGAGAAAAGGG,AAAATTAGAACATTTAAAGTACGTGAACCG,CGACGGATATAGACAATGGAAACTTCGGTA,TGCCAGACCTAAAGGAGTGATTGTTAGCAC,AAGCTAAAGATCGAACTAGCTACGCGCACA,CGATACGCCAAGAGCTCGGGACCGAGATGG,GGTGTAGCCAAAGCCTGATGTCACCAATGC
GCGAAGGAAATGCGGGACTTTGATCAAAGACCGCTGTGAGCGTTGTCGCGCGTTTGGCCCAGGAAACT	ACCGATATTCGAATAGGTATGGAGCGAGAC
GCGGGGGGGAATAGCCCGGGAGGAATGGTCACTGCGGGGAAATAGCCGGGGGGATAGTCACGGTGAG	ACGTTAAGCAGGCACAGACAACCAGAACAA,CAGATTCACGCAAAAGGACGAGGACAAAAT
GCGTCCAGTACTCCGATGCGTTTCCCAGTTCCGCAGTTGATGGTTCCAGTCGAATGTTCGCAGATTA	AACGGTGAAAGAGTTATGAAGATAAGGCGA
GCTTCTCCGGGTTAAACAACGGATGGTTGAACTGCGGGTCTGTCCCGTATACATCCAACACCCGTAA	AGAAGGAGGCGGGAAGAAAAGCATCAGGGC,CCGGGGAAATATAAGTAGAAGAAGTCCGGT
GGTATACAAACAGACCGAATGCGGATATTGCCGCAGTTACATAAAACACAGTTTTCCAGTACGGGAG	CACAAGCCGGCTAGTTTTCAAAAGAGGATT,TTTACAACCCACACCCGGGAAACGAACTCA,CATAAAAACAAGCGGGCCAGGGATGAAACG,ATATATATTTGTACTGCACCAGCAGATAT,AGACCTCGGAAGTCCGAAACCCGCAGAAA,TCAGACTAGCAAAGTGAAAAAGCAACTAAG,AAGATCCGAAACAATTCAGCACCCATAAGC,AGGAGTAACAACTAAATACTGAAGAAAATC,AATAAGAAATAAGCCTTCTAAGAATTGGAA,AGAATAAAAACCCCAATTAAAACATCAGAC,TAATAAAACATTCATAATAGGCAACGTACC,TCTGATCAAAAGGCATCTGAAAACCAAAAA,AAGTCAGCCCTGTACGACCAATGCGCCCGA,GGTACATAACCAGTGAAATATGACAGACCC
GTTAAACGCCCCCATAATGCAGGGCCCTAGCCGCTGTGCTTTCCGGCCGCCGTTGCTCGTTTTTCCAT	GGGTGCGAATAGTTAACTACTAAGAGAAGC,TATTCGTACTCCCTTCCGACAGGGGCCTAC,AGAAAGAACGGCTCGTAGAATAATCAATCA,CACAAGATGAATTCTAGAATAATAAGTAAA,TTCTCCAATAGCCATATGACAACAAACAAA,CGGTGCTGTCAAACCATGGGGTTCGGGCTA
GTTAGGGGTTTCCCCGCTTGGTTAGTTTTCACTGCGGGGGATTTCCTGAGTACGTCACGGAAATCTT	AAAAACACAGAACTGAATCCGCATGATAGC
GTTCAGGATTGTCACTACAGCTAGAGTTCACCGCTGTGATACATTGGTAGCATCCATTGATAAGGTGC	ATGGCATGAAATGGGCGACCAGAGACACTC,TGAAAATTAATCTCCGAAACCAGGACAAAA
GTTGTTCCCCGATTGGGAAAGAGGAAGCAACAGCTGTGTTCTCCAAAGCTGAGTTAATCTAAAAAAAT	CCGTAGCCGATCGACTAGCTGTAAGGACC,CACAAACTGCGCTTATTGGTACTAACCACC,TATAACGGGGGCTATACGAACAGTGGACCC,ACGCATAATAAGTGACAGAAAAAATCGTCA,GCTCGTGATGCCGTCGAAACACGGAAACGA,GCGAGTCTATAGCACATTCGCCAGCGAGT,GCTACGGATAACAAGCTTGTAAGCGAGAGA
GTTTTGGATCTTCCATTAATAAATCATCAACCGCAGTGAGAATGTAACGAACAGTTTGTTCTTTTGA	AGCTTAAGAGAACGCAAAGTATAATACAAC,ACAGTTAAATACCTTAAACAGTAATGATCG
TAAAACACAATCAGGATATTCGGATATTGTGACTGCGGTACAGTCTGTTTCGAGATTATCCACGTGAC	GCAACAACTATGACAACAGTTGAGGCGCAG,AATACAAAGGATCTCTGGTAAAATAAAAAC,TCCCTGCTGAAATCAGCGACCCAGACCTG
TAAACGGTAATTAAACGGATTGGAAAGTTCACTGCGGGCACGGCAATCCAAACATACATTAAAATAT	AAATCGAGCAAGAAAACTAACAAAACCACG,GAAAGAAAAATAAATAAAGCAACCATACCG,GAAAAAACCACTTTTAAACAAACTAAAGAA,ATTCGGATCTAAAAAATTACGGATCCGCGA,ACTTTAGACATTAACAGACGATCCCATGAA,AAAATAAATTTATAAAAGAAATGGGACATT
TAATAATTATTGTGGAAACATTACCCAATTACTGCGGGATTACGGTTATCCAAAATAATTAAAACAA	AACAGCCACCCCTCGCGCGCCGCAGAAGAA,GAAAGCCAGCCCGACGTGCCAGCCGCCAGG,CTCGCTGGTTAGGCGGCTGCCATCCTTAAC
TACAACCTATTTCCGGGATTCGAACCCAATACTGCGGATTACGTTTACAACAAATGGGAACCTAAGA	GGAATAGACACTGCCATTGACCCCATCATG,CTACACAAAAACTAATTTCACAATGAAAAT
TATTATGTTCTAAAAGTGTCCCAACTTCCCCCGCAGTACTATACATACATTATTTCCGGCGATACCA	ATAGGCCCACATAAATTAAAATACATAGAT
TATTTTTCCTCAGTGGAAATCCCGACATTACCGCAGTTATTTTTACCCGTACCATGGATGCCCGTAC	ACAGTGAAATTAAGACGTATAAAACATACA
TATTTTTGACGGATAATCCGGCCCGGGTAACCGCAGTAACCTCAAGAATTTCGAGGTATTGAGTTCG	GAGGACAACCTCAAGGCGGTCGAGGTATGC,TGACTATGATGTAGCGAGTACCAAAAACCG,TGAACAACCATACCAGAATGCAGATGATCG,TCCCCCTAGGCTGATTGTGACATCCTGTCT,CCGAGACCTCGCTCGACAAGAGGGCCGAAT
TCACAATCCTGTATTCCATCACAAAACTGTCCAGCTGTGAGGCATTTTCCGGATTTGCACCTGGGTTTT	TGAAGATCGAGCCATTAGTAGGAAAGTGA,GTAAAAAGGTTATTGACGAGAAAATAGGTG
TCCAGGATGATATCAACATCATCTCCCCATCCAGCTGTGTCTTCATCAATATCAACATCCGCAGCAAGT	CCTAAAGAAAATCTGGGCCAAAATTGGCTC,TATAAGACGGTCGGTCATGATGCAACCAGA,GAAGGGATCGCCCCCAACTGCACAAAATAC,GGTAAATGAATGTCACTCAAGCATACAAAA
TCCGAAAGCACGCAGCGTGCCGGATCACACACTGCGGCCTGGATAGCCGCGTGCTTGGGAGAAAGTC	AAGAATACGCTGTCGTAAGAATGGGAGAAT,ACGCAAATGGGGAATAGAGCGTGGGCAAAC
TCTCTCCCGTGCATAAAGCGCGGAAGTTCTCCGCAGTTTTTGGGACGACGTCCTTACGTAATTCCAT	GTGGTGTATAAAGAAAGCCGATGTTGCTA,ATACAGCAGAACAAGTTCTAGTAATTAAAT,GTTGACGCGTTTATAAACGGAAGACGCAAA,AAAGGATGAAAGACCAAAACCAAAGAGACA,GCCCGAACCGTCCACGGTTCCTTGGAGGTA,TGGACCTGGAAATGGAACATGAAATCAAA
TGAAACGGTTTTCTTGTGCATGGATGGCTTCACAGCTGGGTCCTGTTGGGGAAAAAATTGTAAATGTT	AGCCAGACCGTGGAACCGTCACAGCGAAC,AGAACTAGAGAACGATACCGACGGGATACC,AGCTGAAAAAGACTACAAAATCCGAAAAAT
TGCAGGAAGCACTAAAGCGTGGTGATCGCTCAGCTGTGAAATTTGACAAAGATCCTGTCGGAAATGCT	GAAGACTGGGACTAAAGCCAGAAGAGACAC,CTTATCCCGGACCAATACGAGAGTTTTGCG,AGGGATAATGAAATTGCGAGCAAGTCGAAA
TGCCTCCGGGTGCTTTTAGGTATAAATGCTACTGCGGTAAAAGGATGAAACTTTAGATGGAAAATGC	ACAGAGAAAAACTAAAAACGTACGAGCTAT
TGTTTTTGGAAATTTGGACAAACTATATCCCCGCAGTAATTATGTAATGTTTGAAGTTAACATTATT	CAAACAGACCCTCCGGCTTGCCCACGAAAT,AAATTCTCCAGGAGCAATTTTCCCTATGTT,AAGGGTGCATTTAGAGTCTGGAGATGAAAT,CAAAAAAGAGGTAAAAAGACACAGAGTCAG
TTACATGATCTTCTAATAACGATCCACAACCACAGCGGTATGAAGACCGGAAGCCAGAGCATCCACAT	GCCTTCAGCAAGGTCTATTGCAGGAGCGAC,CATTACAATTACACGACCCAGTAAATCGGT,CCTCACTAACATAAAGTAAGTAATACTCAC,TCCCGGTGATTTAAACAACGAACGTAAAAG,ATACAAAAACGGATAGCGACCATAGCAGCT,TGAATATAAAAAATTTAAGCTGTACCGATA,AACACGGCTACGATAGGAGCATGAAAAAAA,AAACTACCTGAAGCAGTCCGGCTGCCGTGA
TTACTTTAAAGTGTAAACACTGGATGCTTACACAGCTGTGCGGCGCCCTATGTTGCCATTGTGGATAT	AAAAGGATACCAAAGAAAACAAATGTAAAA,ACCAAGCCGGAAAACAGCCAAACGAGCTAC,CACGATTATGCCCAGGGAAGGGGAACGACC,TAAATGCACCAAAAGCCTTGGTACGGAAAC,AAAAGCAACAGATGTAACCACACCACAAGT,AAATAGGTAAAATAAATTGGGACGCAATAG,ACCATTGGAAAGATTAGAGAGGAGTAAGAC,TCCTTTATGGATATTAAGAAAGCTCTAAAA,AAAGCGTGATAACCGTCAAACGACCGCATC,AAATACTTTGGTCGATTGTCACAAGCTCCC,ATTCAGACAAATGAATCGGGGCTGGACGT,ACGTAGGAAGTGCGCAGAAATCCCGTGCCG,AATAACTGTCCAAACCCTGAGCGCCGAAA,ACTGAATAAAAGATATTAGAAAAAACAAAG,GAGCGAACAAACTTCGAGGATTGAGATGAG,ACATCCGAATCCAACACATCTCGAACTTCA
TTATGATCCATAATAATTGCACCACATCCAACTGCGGTATCTGTTTCATGCTCTTATTCCCGGAAAC	TCAGAAAATAACAATTCTAAAAGCCAACAT,GGCGCCAAACACCTGCCGGAGGGCTTACCC,TAAATATTCCATTAAGAAGCTGTCGGATAA,ATCATAAGCGACGTAGCTGGCACGCAGAAG
TTGTTGTAACCACCAAGCTCCTACCTTTTACCGCTGTGTTGATCTTCCTGGATTGGCAAATTCAAGCT	TTACGAAGAGGCTGATTGAAAGAAACTAG,TAACACAAAAAAGAGAATAAAAATGAAAAA,ATGCGAATACCCCACACGCCGGAAAAGGAA,GAGTGACCACCCCGCCCAACTAAGGGTAGG
TTGTTGTTACCACCAAGCTCCTACCTTTTACCGCTGTGTTGATCTTCCTGGATTGGCAAATTCAAGCT	CAGCAGAAGGAAACATGTAGACATAGGGAC,CCCGCCACGACACCCACGATAGTGCAAGCC,CTTATCCCTCAGTATACAATGGACAAATCA,AAAGAAGCGATGCAGCAGCCTACAAGACGC,CGAGCCCACAAGAGGATCGTAAGTCAGACC,TTGATGGATCTGAAGAAAAAAATCTGTAAA,CTAGAGCTCGAGTCTATAACGAAGGAGAAT,GCTATAGGACAGAAAGTCAGACCGAAGATA,TTTAATGAAAGAACTACAAAACTCAACATC,TAGCGCAGTTTTGCCGATCGAACAACTGAA,AGAAACACATAGGCGACTATCGGGAGCTCG,CAACTGAAATAAGAACATGCGACACACTAG
TTGTTTCCAACAAGCAGGAATGGAATGCTACCAGCTGTGGTTGAGTCTACACCTTTCACTCGTAAGATT	AATAAAAAGCGGCTTTCACAACTCAAACCT,TCTAAGTACTAAACAAAAAATTGGAAGTCG,GGAAAAACCCTAATTAACATCAACCTAGGC,CAGGGAGCCTATGACCATCGCGTTACGAAA,AAACGCAAAAAGATCAAAACGAACGCAATA,TAAAAAGGGACAATTAAATCAAACAAATCC,AAAAGCACATAATGATTAACGCAATATAAT,AGTACTTAGAGCAACATTATGCCGAGTTGG,GATACATCAATGCAAGAGGGCGGGAGAGAA,TGCGCGTCACCCGTATCGCGACCCAAAGAA,CAGTGAGGGAGGAAAAAACAATGGGCTATA
TTTTACATTTATTTAAAATCCAAATTTTCCCACAGCTGAATGAAATTACAAAAAATAAAATAAATAAA	ACCAATAACACAACACCAGCTAGGGAGTTA,AAGAAGCCGCAATGAGACTGCAGGTAACAT,GGATGTAACGAAAGAAACATATCGAGCACA,TCCCAGCTGTGTAACCGATAAAGCGCCCAC,CGAGGTGCGGGGGTATCATATCCCTTCGAG
TTTTACTTGGCATTTCCGGATTACGCCGGTACTGCGGCACCGGTATCCCCCATGATTGCTTGCGTCA	GACAGGTTTCCATATGGCGGAACAACTAC,TCATTAATCAAGAATTATCAGAAATGTTAA,GACTGGGCAAAGAAACCCAGAGCGGGACGC,CCCATCAAGTGCGCCGGGTCTACGAAACCA,AGTATAACGAGATGACAAGGGCAAAGACCG
TTTTGGGCCGGAAAATGTGTCTCACCGTTTGACTGCGGCACACACGGTACCGGTGACGCCATTTCCGG	TACGCTGCCATGAAAGATCCTATGCGTACA
